111111111111111111111
1P000000C000000C1111
111101111111111110111
1111000000E1111110111
111111111111111110111
100000000000111110111
111111111111111111111