11111111111111111111
100001000C0000100011
10110101111110101E01
101000P0000000000101
10101101100110110101
10101101111110110101
10100000000000000101
10110101111110101101
10000100000000100001
11111111111111111111