1111111111111111111111111111111111
1000000000000000011111111111111111
1111111111111111101111111111111111
1111111111111111101111111111111111
1111111111111111101111111111111111
1000000000001111101111111111111111
1111111111101111101111111111111111
1111111111101111101111111111111111
1111111111101111101111111111111111
1000001111101111101111111111111111
1111101111101111101111111111111111
1111101111101111101111111111111111
1111101111101111101111111111111111
10000PCCCCCCCCCCCCCCCCCCCCCCCCCCE1
1101111101111101111111111111111111
1001111101111101111111111111111111
1111111101111101111111111111111111
1111111101111101111111111111111111
1111111101111101111111111111111111
1000000001111101111111111111111111
1111111111111101111111111111111111
1111111111111101111111111111111111
1111111111111101111111111111111111
1000000000000001111111111111111111
1111111111111111111111111111111111