11111111111111111111
10000000000000000001
10000010000000000001
100000000000C0000001
100E000CC00000000001
1000000P000000000001
11111111111111111111
