11111111111        
10101010101
10101010101
10101010101
10101010101
11111111111
